col_1,행정동,세대수,등록인구,등록인구(남),등록인구(여),한국인,한국인(남),한국인(여),외국인,외국인(남),외국인(여),세대당인구,65세이상고령자,평균연령,인구밀도 (명/㎢),면적 (㎢),치안기관,유흥업소 수,초등학교 수,"중,고등학교 수",대학교 수,가로등 수,보안등 수,어린이용 CCTV 수,전체 CCTV수(어린이보호 제외),안전비상벨 수,상가 수,요리 주점,일반 유흥 주점,입시·교과학원,생활방범 CCTV 수,기타 CCTV 수,시설물 CCTV 수,쓰레기단속 CCTV 수,범죄발생수(유동인구기준),범죄발생수(면적기준),강력범죄,절도범죄,폭력범죄
중구,소계,40749,80965,38815,42150,80199,38460,41739,766,355,411,1.97,16107,44.4,11468,7.06,0,0,0,0,0,0,0,0,0,0,0,0,0,0,0,,0,0,2606,2606,221,1236,1149
중구,동인동,4636,7676,3824,3852,7579,3782,3797,97,42,55,1.63,1886,48.2,7754,0.99,1,5,1,0,0,637,171,10,159,2,1031,22,3,3,135,,0,24,247.0654727,365.4305949,221,1236,1149
중구,삼덕동,4090,6499,3082,3417,6405,3037,3368,94,45,49,1.57,862,39.7,10155,0.64,0,34,2,0,0,210,209,18,147,7,1472,104,18,3,124,,0,23,209.1816711,236.2379603,221,1236,1149
중구,성내1동,3403,4887,2345,2542,4805,2305,2500,82,40,42,1.41,838,42.6,5430,0.9,0,10,2,1,0,242,217,12,171,3,3262,83,8,16,150,,0,21,157.2966343,332.2096317,221,1236,1149
중구,성내2동,2950,4765,2405,2360,4654,2347,2307,111,58,53,1.58,1139,47,6270,0.76,4,24,1,2,0,339,198,9,186,2,2533,45,20,4,155,,6,25,153.3698512,280.5325779,221,1236,1149
중구,성내3동,2306,4887,2445,2442,4847,2422,2425,40,23,17,2.1,869,42.6,6186,0.79,1,2,1,0,0,497,132,15,164,2,373,1,2,5,147,,2,15,157.2966343,291.6062323,221,1236,1149
중구,대신동,3215,7515,3654,3861,7494,3648,3846,21,6,15,2.33,1489,44.6,14452,0.52,0,3,1,1,0,124,209,9,70,2,2630,2,3,6,56,,0,14,241.8834064,191.9433428,221,1236,1149
중구,남산1동,2565,4509,2154,2355,4455,2128,2327,54,26,28,1.74,970,45.8,11562,0.39,0,3,1,1,0,147,139,8,73,3,644,6,3,7,55,,0,18,145.1300438,143.9575071,221,1236,1149
중구,남산2동,3116,6877,3270,3607,6827,3241,3586,50,29,21,2.19,1155,41.9,18097,0.38,1,1,1,0,0,158,103,9,80,0,558,3,0,7,58,,0,22,221.3482616,140.266289,221,1236,1149
중구,남산3동,2849,6501,3000,3501,6460,2988,3472,41,12,29,2.27,1494,46.5,16253,0.4,0,0,0,2,0,98,152,17,114,1,301,2,0,4,83,,0,31,209.2460446,147.6487252,221,1236,1149
중구,남산4동,5993,14313,6711,7602,14278,6699,7579,35,12,23,2.38,2984,44.6,31807,0.45,0,0,0,0,0,130,320,12,93,3,370,3,0,17,81,,0,12,460.688915,166.1048159,221,1236,1149
중구,대봉1동,3504,7818,3648,4170,7701,3598,4103,117,50,67,2.2,1583,44.9,13251,0.59,0,0,0,2,0,342,28,2,81,0,1078,36,1,5,64,,0,17,251.6359909,217.7818697,221,1236,1149
중구,대봉2동,2122,4718,2277,2441,4694,2265,2429,24,12,12,2.21,838,43.6,18872,0.25,0,3,0,0,0,98,79,0,61,0,290,5,1,0,49,,0,12,151.857074,92.28045326,221,1236,1149
동구,소계,159422,341326,167357,173969,339530,166741,172789,1796,616,1180,2.13,73354,46.1,1874,182.15,0,0,0,0,0,0,0,0,0,0,0,0,0,0,0,,0,0,3450,3450,175,1505,1770
동구,신암1동,4564,8930,4473,4457,8885,4457,4428,45,16,29,1.95,2494,49.5,14883,0.6,1,6,1,1,0,104,212,0,76,2,527,28,5,4,73,,0,3,90.26121655,11.36426023,175,1505,1770
동구,신암2동,4437,10190,4813,5377,10160,4802,5358,30,11,19,2.29,2335,46,26816,0.38,1,3,1,0,0,107,16,0,26,4,327,11,6,12,23,,0,3,102.9968417,7.197364809,175,1505,1770
동구,신암3동,4970,11435,5593,5842,11398,5583,5815,37,10,27,2.29,2074,43,18746,0.61,0,7,1,0,0,108,35,0,51,4,394,8,7,11,49,,0,2,115.5808523,11.55366456,175,1505,1770
동구,신암4동,6198,11147,5552,5595,11071,5521,5550,76,31,45,1.79,2781,49.6,9609,1.16,1,24,1,0,0,669,86,0,74,5,518,16,25,2,69,,0,5,112.6698523,21.9709031,175,1505,1770
동구,신암5동,3131,6189,2915,3274,6158,2907,3251,31,8,23,1.97,1886,52.1,12135,0.51,0,3,2,2,0,100,81,0,37,3,315,6,3,7,37,,0,0,62.55617796,9.659621191,175,1505,1770
동구,신천1·2동,6052,12516,5891,6625,12487,5886,6601,29,5,24,2.06,3419,49.3,26075,0.48,0,0,0,0,0,0,0,0,0,0,0,0,0,0,0,,0,0,126.5072101,9.09140818,175,1505,1770
동구,신천3동,6372,14626,7226,7400,14557,7193,7364,69,33,36,2.28,2361,42.9,20894,0.7,1,6,1,2,0,66,20,0,34,5,734,9,4,19,27,,0,7,147.8343285,13.2583036,175,1505,1770
동구,신천4동,5066,8403,4136,4267,8318,4106,4212,85,30,55,1.64,1826,46.7,10773,0.78,0,91,1,0,0,338,93,0,56,4,1730,57,98,4,50,,0,6,84.93449078,14.77353829,175,1505,1770
동구,효목1동,6929,13268,6554,6714,13200,6534,6666,68,20,48,1.91,3981,51.6,9685,1.37,0,7,1,1,0,256,335,0,76,3,755,34,11,0,73,,0,3,134.1081547,25.94839418,175,1505,1770
동구,효목2동,6309,12810,6092,6718,12763,6074,6689,47,18,29,2.02,3289,48.9,17792,0.72,0,7,1,0,0,397,155,0,78,3,630,20,1,8,69,,0,9,129.478856,13.63711227,175,1505,1770
동구,도평동,2042,3920,2102,1818,3899,2095,1804,21,7,14,1.91,1092,50,189,20.73,0,0,0,0,0,95,73,0,38,2,73,1,0,1,19,,12,7,39.621945,392.6351908,175,1505,1770
동구,불로봉무동,8756,21161,10382,10779,20990,10307,10683,171,75,96,2.4,3538,42.9,2720,7.78,0,2,1,0,1,0,0,0,0,0,0,0,0,0,0,,0,0,213.8877495,147.3565743,175,1505,1770
동구,지저동,6863,14161,7053,7108,14072,7030,7042,89,23,66,2.05,3730,50.2,6526,2.17,0,3,0,1,0,475,205,0,69,2,381,9,0,3,65,,0,4,143.1342763,41.10074115,175,1505,1770
동구,동촌동,7803,15381,7700,7681,15273,7670,7603,108,30,78,1.96,3826,48.9,4037,3.81,1,4,1,1,0,214,167,0,90,2,569,21,5,1,80,,0,10,155.4655959,72.16305243,175,1505,1770
동구,방촌동,8394,18548,8925,9623,18472,8909,9563,76,16,60,2.2,4792,49.6,14721,1.26,0,3,3,1,0,295,379,0,80,5,577,16,0,12,66,,10,4,187.4764888,23.86494647,175,1505,1770
동구,해안동,7233,14920,7457,7463,14851,7439,7412,69,18,51,2.05,4091,50.1,1122,13.3,0,1,1,1,0,254,168,0,88,2,466,14,2,2,71,,0,17,150.8059743,251.9077683,175,1505,1770
동구,안심1동,19802,41509,20211,21298,41269,20138,21131,240,73,167,2.08,8237,45,12578,3.3,0,5,4,2,0,1092,1382,0,217,19,1702,48,6,26,207,,0,10,419.5579886,62.50343124,175,1505,1770
동구,안심2동,5293,11552,5743,5809,11488,5728,5760,64,15,49,2.17,2717,48.5,847,13.64,1,0,0,1,0,1187,508,0,192,8,363,1,0,0,176,,0,16,116.7634461,258.3475158,175,1505,1770
동구,안심3동,8685,21921,10656,11265,21803,10603,11200,118,53,65,2.51,3035,40.3,3594,6.1,0,2,3,2,0,605,245,0,100,9,696,14,0,64,95,,0,5,221.5695552,115.5366456,175,1505,1770
동구,안심4동,11858,28547,14130,14417,28390,14063,14327,157,67,90,2.39,4616,43,11283,2.53,2,5,1,2,0,468,237,0,82,3,945,9,3,19,75,,0,7,288.5427714,47.91929728,175,1505,1770
동구,혁신동,8820,18673,9228,9445,18590,9195,9395,83,33,50,2.11,1891,37.3,1137,16.42,1,0,2,2,0,1495,838,0,154,5,1018,13,7,27,145,,3,6,188.7399436,311.0019215,175,1505,1770
동구,공산동,9845,21519,10525,10994,21436,10501,10935,83,24,59,2.18,5343,48.4,257,83.8,2,0,3,2,0,1592,143,0,103,3,716,9,0,7,71,1,7,24,217.5062843,1587.208345,175,1505,1770
서구,소계,81116,161935,80754,81181,159827,79580,80247,2108,1174,934,1.97,40897,49.8,9350,17.32,0,0,0,0,0,0,0,0,0,0,0,0,0,0,0,,0,0,2032,2032,79,866,1087
서구,내당1동,4922,10142,5013,5129,10104,5004,5100,38,9,29,2.05,2179,46.8,21579,0.47,1,18,1,0,0,74,61,22,98,0,428,20,16,3,96,2,0,0,127.2642974,55.1408776,79,866,1087
서구,내당2·3동,4906,9323,4490,4833,9261,4466,4795,62,24,38,1.89,2802,52.3,14343,0.65,0,0,0,0,0,0,0,0,0,0,0,0,0,0,0,,0,0,116.987285,76.25866051,79,866,1087
서구,내당4동,7955,16054,7683,8371,15974,7652,8322,80,31,49,2.01,3891,48.7,21405,0.75,1,9,1,3,0,172,260,33,172,4,785,34,8,12,128,34,10,0,201.4495199,87.99076212,79,866,1087
서구,비산1동,4862,9416,4773,4643,9320,4734,4586,96,39,57,1.92,2575,51.5,14713,0.64,0,1,2,0,0,28,134,54,115,4,212,9,1,1,95,20,0,0,118.1542718,75.08545035,79,866,1087
서구,비산2·3동,4968,8929,4359,4570,8873,4341,4532,56,18,38,1.79,2946,53.9,18222,0.49,0,0,0,0,0,0,0,0,0,0,0,0,0,0,0,,0,0,112.0432766,57.48729792,79,866,1087
서구,비산4동,4709,9501,4603,4898,9464,4595,4869,37,8,29,2.01,2578,51,24362,0.39,0,2,1,2,0,60,108,36,127,4,310,17,1,1,113,8,6,0,119.2208726,45.7551963,79,866,1087
서구,비산5동,3346,6028,3064,2964,5865,2979,2886,163,85,78,1.75,1861,53.3,21529,0.28,0,1,1,0,0,60,43,21,116,0,337,47,7,5,107,9,0,0,75.64081885,32.84988453,79,866,1087
서구,비산6동,3743,7403,3637,3766,7351,3618,3733,52,19,33,1.96,2004,51.6,27419,0.27,0,4,0,0,0,65,64,27,75,0,228,9,3,0,69,6,0,0,92.89465526,31.67667436,79,866,1087
서구,비산7동,5428,10397,5638,4759,9565,5054,4511,832,584,248,1.76,2559,51.2,3795,2.74,1,8,1,0,0,786,234,27,342,8,794,49,7,0,334,2,6,0,130.4640998,321.4595843,79,866,1087
서구,평리1동,3939,7602,3795,3807,7541,3776,3765,61,19,42,1.91,2026,50.8,19492,0.39,0,5,1,0,0,74,151,38,102,0,295,22,4,2,88,14,0,0,95.39175595,45.7551963,79,866,1087
서구,평리2동,3544,7723,3760,3963,7690,3747,3943,33,13,20,2.17,1749,47.3,26631,0.29,0,1,1,0,0,41,8,49,70,8,206,7,0,4,62,8,0,0,96.91009356,34.02309469,79,866,1087
서구,평리3동,5013,9662,4850,4812,9588,4825,4763,74,25,49,1.91,2546,51,12548,0.77,2,8,1,4,0,149,120,47,195,4,638,18,8,7,174,21,0,0,121.24114,90.33718245,79,866,1087
서구,평리4동,8420,17519,8681,8838,17442,8661,8781,77,20,57,2.07,3614,46.8,23999,0.73,1,37,0,0,0,162,2,24,176,0,920,39,30,8,159,17,0,0,219.8326983,85.6443418,79,866,1087
서구,평리5동,867,1660,897,763,1641,886,755,19,11,8,1.89,442,50.2,3952,0.42,0,1,1,0,1,169,12,18,98,4,175,6,3,3,76,22,0,0,20.83008615,49.27482679,79,866,1087
서구,평리6동,1755,3432,1869,1563,3352,1811,1541,80,58,22,1.91,893,51.8,4701,0.73,0,0,1,0,0,256,72,15,62,0,162,1,0,1,53,9,0,0,43.06557569,85.6443418,79,866,1087
서구,상중이동,8779,19751,9903,9848,19469,9718,9751,282,185,97,2.22,4102,46.9,2944,6.71,1,3,2,3,0,1356,660,53,491,36,1154,12,4,9,402,87,2,0,247.8403804,787.2240185,79,866,1087
서구,원대동,3960,7393,3739,3654,7327,3713,3614,66,26,40,1.85,2130,51.9,12322,0.6,1,17,1,1,0,124,117,57,141,12,424,13,14,4,134,7,0,0,92.76917282,70.3926097,79,866,1087
남구,소계,76401,143474,68740,74734,141519,67842,73677,1955,898,1057,1.85,35590,48.5,8231,17.43,0,0,0,0,0,0,0,0,0,0,0,0,0,0,0,,0,0,1501,1501,73,656,772
남구,이천동,5422,11682,5518,6164,11548,5453,6095,134,65,69,2.13,3170,49.2,10717,1.09,0,0,2,1,0,445,165,23,61,8,494,12,0,17,59,,0,1,122.2150494,93.86632243,73,656,772
남구,봉덕1동,5152,8987,4330,4657,8832,4265,4567,155,65,90,1.71,2398,50.4,18341,0.49,1,6,0,0,0,250,20,3,57,10,640,11,9,0,49,,0,0,94.02042879,42.19678715,73,656,772
남구,봉덕2동,5340,12224,5783,6441,12070,5708,6362,154,75,79,2.26,2969,47.3,3995,3.06,0,0,0,0,0,526,180,3,60,4,436,8,2,1,55,,0,0,127.885359,263.5146299,73,656,772
남구,봉덕3동,8219,16168,7694,8474,15944,7587,8357,224,107,117,1.94,4097,48.7,6010,2.69,1,17,2,4,0,383,146,27,59,12,848,18,19,17,54,,0,0,169.1468001,231.6517499,73,656,772
남구,대명1동,5746,10994,5365,5629,10803,5262,5541,191,103,88,1.88,2581,48.1,24431,0.45,0,5,0,0,0,0,78,18,34,8,344,9,4,4,24,,0,0,115.0173132,38.75215146,73,656,772
남구,대명2동,7017,12115,5735,6380,11983,5670,6313,132,65,67,1.71,2534,45.3,14596,0.83,0,1,1,4,1,38,78,20,75,8,772,11,1,9,65,,0,0,126.74502,71.47619048,73,656,772
남구,대명3동,6255,10621,5232,5389,10474,5171,5303,147,61,86,1.67,2897,50.2,11299,0.94,1,6,0,0,1,272,208,13,121,16,952,27,4,4,102,,0,0,111.1150522,80.94893861,73,656,772
남구,대명4동,5813,10627,5131,5496,10560,5112,5448,67,19,48,1.82,2856,49.9,14968,0.71,1,10,1,2,0,142,38,17,72,18,620,9,12,2,64,,0,0,111.1778232,61.14228342,73,656,772
남구,대명5동,3515,6423,3054,3369,5962,2808,3154,461,246,215,1.7,1372,46.7,6982,0.92,1,9,1,1,1,135,218,12,44,4,593,20,11,2,30,,0,0,67.19630734,79.22662077,73,656,772
남구,대명6동,5964,11297,5396,5901,11235,5377,5858,62,19,43,1.88,2342,46.1,7531,1.5,1,1,1,0,0,7,61,12,93,2,565,6,1,9,77,,0,0,118.1872465,129.1738382,73,656,772
남구,대명9동,8333,15165,7385,7780,15044,7344,7700,121,41,80,1.81,3454,47.8,4487,3.38,1,8,2,1,0,896,336,29,114,10,780,22,7,6,94,,0,0,158.6535888,291.0717154,73,656,772
남구,대명10동,4972,8850,4178,4672,8799,4164,4635,51,14,37,1.77,2468,50.2,17700,0.5,0,21,0,0,0,29,21,6,29,4,647,18,18,1,29,,0,0,92.58715865,43.05794607,73,656,772
남구,대명11동,4653,8321,3939,4382,8265,3921,4344,56,18,38,1.78,2452,51.5,9564,0.87,0,3,1,0,0,48,57,16,48,4,606,8,2,2,27,,0,0,87.05285278,74.92082616,73,656,772
북구,소계,192697,436173,216633,219540,430912,214151,216761,5261,2482,2779,2.24,70487,43.6,4641,93.99,0,0,0,0,0,0,0,0,0,0,0,0,0,0,0,,0,0,3475,3475,153,1638,1684
북구,고성동,2195,4718,2287,2431,4699,2279,2420,19,8,11,2.14,1108,46.7,8902,0.53,0,1,0,0,0,270,31,6,32,0,463,28,3,6,25,,4,3,37.58841102,19.5951697,153,1638,1684
북구,칠성동,10318,23141,11021,12120,23005,10975,12030,136,46,90,2.23,3902,42.7,17399,1.33,2,13,1,3,0,807,33,14,126,0,1339,17,6,10,88,,19,19,184.3648621,49.17278434,153,1638,1684
북구,침산1동,2008,4116,2231,1885,3960,2104,1856,156,127,29,1.97,1071,51.2,3319,1.24,1,0,0,1,0,240,181,7,45,0,196,0,0,0,36,,5,4,32.79226362,45.84530269,153,1638,1684
북구,침산2동,6900,18425,8865,9560,18364,8843,9521,61,22,39,2.66,2477,40.5,18611,0.99,0,0,1,0,0,396,10,16,32,0,567,14,1,35,26,,4,2,146.7923851,36.60229812,153,1638,1684
북구,침산3동,7478,19417,9334,10083,19342,9302,10040,75,32,43,2.59,3449,43.9,18147,1.07,1,1,2,2,0,490,296,10,97,0,494,4,0,31,29,,63,5,154.6956712,39.56005958,153,1638,1684
북구,노원동,5646,11460,6063,5397,11098,5790,5308,362,273,89,1.97,2773,49.7,3709,3.09,0,19,0,0,0,822,211,7,91,2,1095,18,10,1,74,3,9,5,91.30207509,114.2435365,153,1638,1684
북구,산격1동,5136,8855,4387,4468,8784,4359,4425,71,28,43,1.71,2988,54.5,9731,0.91,1,1,1,0,0,213,312,9,85,0,245,6,0,1,66,,15,4,70.54798211,33.64453665,153,1638,1684
북구,산격2동,4703,10606,5180,5426,10527,5141,5386,79,39,40,2.24,2188,47.1,4631,2.29,0,13,1,1,0,712,653,14,43,2,1257,8,10,6,35,,4,4,84.49823808,84.66592191,153,1638,1684
북구,산격3동,6375,10595,5502,5093,9375,4936,4439,1220,566,654,1.47,1774,43.1,13244,0.8,0,2,1,0,1,115,452,12,98,0,952,50,1,9,44,,43,11,84.41060084,29.57761464,153,1638,1684
북구,산격4동,4506,8352,4366,3986,8214,4306,3908,138,60,78,1.82,2151,49.5,11286,0.74,0,0,0,0,0,179,108,14,59,1,361,3,0,4,50,,6,3,66.54056991,27.35929354,153,1638,1684
북구,복현1동,5106,7921,4357,3564,7469,4166,3303,452,191,261,1.46,1072,41.5,20310,0.39,1,56,1,0,0,124,80,12,78,0,482,31,58,3,40,,31,7,63.10678332,14.41908714,153,1638,1684
북구,복현2동,12715,31481,15578,15903,31038,15377,15661,443,201,242,2.44,4444,42.1,16925,1.86,0,1,2,6,2,233,166,27,53,1,590,8,1,21,44,,4,5,250.8098278,68.76795404,153,1638,1684
북구,대현동,8911,17602,8915,8687,17052,8602,8450,550,313,237,1.91,3929,46.5,14428,1.22,0,15,1,0,0,307,55,12,51,0,756,27,9,7,44,,2,5,140.2355258,45.10586233,153,1638,1684
북구,검단동,3164,6432,3239,3193,6261,3111,3150,171,128,43,1.98,1734,51,1688,3.81,0,0,0,2,0,152,151,5,214,0,181,4,0,2,192,,18,4,51.24388717,140.8633897,153,1638,1684
북구,무태조야동,15251,36020,18322,17698,35818,18247,17571,202,75,127,2.35,5128,42.2,1549,23.25,1,1,4,2,0,1661,803,55,138,2,1214,25,2,43,125,,10,3,286.9721418,859.5994255,153,1638,1684
북구,관문동,14684,36007,17863,18144,35862,17821,18041,145,42,103,2.44,4888,41.3,2461,14.63,1,4,5,2,0,1387,646,27,94,2,800,13,5,29,81,2,7,4,286.8685705,540.9006277,153,1638,1684
북구,태전1동,10750,22265,11132,11133,21984,10997,10987,281,135,146,2.05,3854,44.6,8246,2.7,0,1,2,2,2,570,524,24,61,2,799,33,0,2,47,,5,9,177.3857506,99.82444941,153,1638,1684
북구,태전2동,10847,24244,11825,12419,24007,11740,12267,237,85,152,2.21,4085,44.5,14178,1.71,1,6,2,3,0,421,283,32,59,2,932,25,6,11,53,,3,3,193.1524877,63.22215129,153,1638,1684
북구,구암동,13459,34320,16764,17556,34216,16749,17467,104,15,89,2.54,4106,41.9,7782,4.41,1,12,3,7,0,740,625,42,91,7,991,42,12,21,64,,25,2,273.4282039,163.0466007,153,1638,1684
북구,관음동,7428,16043,8084,7959,15957,8061,7896,86,23,63,2.15,3182,47,5348,3,0,3,2,1,0,307,384,22,89,5,558,23,3,5,54,,32,3,127.8149381,110.9160549,153,1638,1684
북구,읍내동,11684,26245,12964,13281,26156,12942,13214,89,22,67,2.24,4361,44.6,4596,5.71,1,2,3,2,0,457,530,52,88,1,921,19,2,9,82,,4,2,209.0944992,211.1102245,153,1638,1684
북구,동천동,10585,27366,13272,14094,27294,13257,14037,72,15,57,2.58,2786,40.5,24434,1.12,1,34,3,0,0,714,550,22,54,3,1381,78,30,87,40,,11,3,218.0255312,41.4086605,153,1638,1684
북구,국우동,12848,30542,15082,15460,30430,15046,15384,112,36,76,2.37,3037,39.6,1777,17.19,1,0,4,5,0,1488,334,33,69,0,943,15,2,27,48,,17,4,243.3287939,635.5489946,153,1638,1684
수성구,소계,171480,413211,199433,213778,411553,198731,212822,1658,702,956,2.4,72078,43.8,5399,76.53,0,0,0,0,0,0,0,0,0,0,0,0,0,0,0,,0,0,2851,2851,135,1138,1578
수성구,범어1동,6249,16285,7730,8555,16227,7707,8520,58,23,35,2.6,2378,41.3,15079,1.08,2,6,1,1,0,331,31,18,126,0,907,32,15,43,60,65,1,0,112.3603558,40.23363387,135,1138,1578
수성구,범어2동,6857,15139,7310,7829,15010,7245,7765,129,65,64,2.19,2381,42.8,13397,1.13,0,4,1,0,0,182,59,23,85,4,1053,4,4,77,73,12,0,0,104.4533882,42.0963021,135,1138,1578
수성구,범어3동,6386,17100,8203,8897,17016,8165,8851,84,38,46,2.66,1731,38.5,29483,0.58,0,14,2,0,0,203,0,9,52,0,1104,38,17,39,38,14,0,0,117.9835484,21.60695152,135,1138,1578
수성구,범어4동,6714,19882,9763,10119,19836,9743,10093,46,20,26,2.95,1975,37.9,18409,1.08,0,0,1,6,0,157,39,9,83,0,1107,12,2,274,55,28,0,0,137.1782987,40.23363387,135,1138,1578
수성구,만촌1동,8910,22238,10819,11419,22167,10793,11374,71,26,45,2.49,4347,44.8,7722,2.88,1,1,2,3,0,698,212,15,128,4,803,13,1,30,103,6,19,0,153.4338098,107.2896903,135,1138,1578
수성구,만촌2동,5042,10843,5374,5469,10754,5344,5410,89,30,59,2.13,2094,45.5,6693,1.62,1,1,2,0,0,298,48,19,105,0,596,5,2,37,84,8,9,4,74.81260905,60.3504508,135,1138,1578
수성구,만촌3동,6856,19327,10110,9217,19174,10021,9153,153,89,64,2.8,2306,40.3,10858,1.78,0,0,1,7,1,780,179,28,98,0,749,8,1,74,87,4,3,4,133.3490081,66.31098915,135,1138,1578
수성구,수성1가동,7093,17416,7940,9476,17372,7921,9451,44,19,25,2.45,3749,45.7,30028,0.58,0,3,1,2,0,81,10,10,47,0,643,11,3,27,43,3,1,0,120.1638291,21.60695152,135,1138,1578
수성구,수성2·3가동,4562,11421,5541,5880,11383,5524,5859,38,17,21,2.5,2022,43.2,17571,0.65,0,1,0,0,0,0,0,0,0,0,0,0,0,0,0,,0,0,78.80059098,24.21468705,135,1138,1578
수성구,수성4가동,5748,13985,6505,7480,13945,6493,7452,40,12,28,2.43,3004,47,22198,0.63,0,1,0,2,0,176,51,8,34,0,635,30,4,12,32,2,0,0,96.49122361,23.46961976,135,1138,1578
수성구,황금1동,8175,23047,11014,12033,23011,10994,12017,36,20,16,2.81,3161,41,8568,2.69,1,0,1,0,0,258,228,10,30,0,357,2,0,36,28,2,0,0,159.0156046,100.211551,135,1138,1578
수성구,황금2동,6130,12156,5862,6294,12079,5833,6246,77,29,48,1.97,2273,44.1,10479,1.16,0,52,1,2,0,157,49,11,134,0,988,38,55,14,103,18,0,13,83.87181367,43.21390304,135,1138,1578
수성구,중동,6293,12646,6261,6385,12567,6231,6336,79,30,49,2,2316,44.5,13897,0.91,0,12,1,0,0,243,81,11,111,0,791,14,9,12,69,42,0,0,87.2526288,33.90056187,135,1138,1578
수성구,상동,7797,15896,7723,8173,15767,7670,8097,129,53,76,2.02,3690,47.5,11952,1.33,0,0,1,1,0,377,290,24,101,0,976,19,3,24,86,,9,6,109.6764026,49.54697504,135,1138,1578
수성구,파동,5371,12117,5790,6327,12089,5779,6310,28,11,17,2.25,3110,48.1,2082,5.82,1,0,1,1,0,278,322,11,80,0,329,9,0,12,71,9,0,0,83.60272839,216.8145825,135,1138,1578
수성구,두산동,7352,14825,7210,7615,14685,7149,7536,140,61,79,2,2183,43.4,7525,1.97,1,32,1,0,0,342,221,26,176,6,1513,114,53,10,76,25,61,14,102.2869067,73.38912845,135,1138,1578
수성구,지산1동,10478,21243,10127,11116,21139,10091,11048,104,36,68,2.02,4976,48.3,8047,2.64,0,7,3,2,0,884,169,39,111,6,1288,43,7,26,87,7,15,2,146.5686852,98.34888279,135,1138,1578
수성구,지산2동,7816,18006,8474,9532,17970,8461,9509,36,13,23,2.3,3961,47.1,9140,1.97,1,0,1,2,0,201,273,20,70,8,759,18,2,18,57,2,11,0,124.2346065,73.38912845,135,1138,1578
수성구,범물1동,5929,11009,4972,6037,10980,4959,6021,29,13,16,1.85,3820,54,2024,5.44,0,0,2,1,0,185,49,25,50,6,377,8,0,8,21,5,24,0,75.95794642,202.6583039,135,1138,1578
수성구,범물2동,6588,16705,8053,8652,16675,8044,8631,30,9,21,2.53,2999,44.5,7170,2.33,0,0,1,1,0,240,60,26,46,8,396,8,1,20,36,,10,0,115.2581974,86.80033974,135,1138,1578
수성구,고산1동,11696,31427,15213,16214,31356,15185,16171,71,28,43,2.68,4246,41.8,3575,8.79,0,3,3,4,0,432,0,40,115,4,1089,18,4,108,79,21,15,0,216.8344429,327.4570757,135,1138,1578
수성구,고산2동,10945,28089,13862,14227,28014,13829,14185,75,33,42,2.56,4421,42.8,1148,24.47,1,0,3,3,0,2760,776,31,257,14,1213,18,0,27,132,59,66,0,193.8035023,911.5898341,135,1138,1578
수성구,고산3동,12493,32409,15577,16832,32337,15550,16787,72,27,45,2.59,4935,43.5,6469,5.01,1,0,3,1,0,435,171,32,99,2,805,25,0,40,72,3,24,0,223.6098724,186.6393571,135,1138,1578
달서구,소계,235883,547387,269892,277495,536989,263961,273028,10398,5931,4467,2.28,89178,44,8776,62.37,0,0,0,0,0,0,0,0,0,0,0,0,0,0,0,,0,0,4436,4436,228,2064,2144
달서구,성당동,10609,22784,11066,11718,22636,11005,11631,148,61,87,2.13,4987,46.7,11449,1.99,1,16,1,6,0,332,425,17,166,2,1041,35,18,15,161,5,0,0,184.6405267,141.5366362,228,2064,2144
달서구,두류1·2동,8389,14542,7091,7451,14401,7053,7348,141,38,103,1.72,3433,48.2,10934,1.33,0,0,0,0,0,0,0,0,0,0,0,0,0,0,0,,0,0,117.8477238,94.59483726,228,2064,2144
달서구,두류3동,4023,7951,3850,4101,7900,3832,4068,51,18,33,1.96,2025,48.7,7099,1.12,1,2,1,0,0,165,521,8,71,0,763,48,3,5,66,5,0,0,64.43455179,79.65881033,228,2064,2144
달서구,본리동,8015,20162,9938,10224,19804,9762,10042,358,176,182,2.47,2746,42.1,18497,1.09,0,15,2,3,0,226,45,16,81,2,704,21,18,12,70,11,0,0,163.3919549,77.52509219,228,2064,2144
달서구,감삼동,12055,28405,13825,14580,28272,13769,14503,133,56,77,2.35,3983,42.3,24072,1.18,1,18,2,0,0,326,175,19,129,0,1394,35,14,17,125,4,0,0,230.1928617,83.92624659,228,2064,2144
달서구,죽전동,6780,13125,6461,6664,12981,6395,6586,144,66,78,1.91,2431,46.5,17736,0.74,0,9,1,0,0,68,141,2,103,0,906,12,7,5,92,11,0,0,106.3644186,52.63171397,228,2064,2144
달서구,장기동,7143,17082,8500,8582,16674,8190,8484,408,310,98,2.33,2641,43.8,5493,3.11,0,4,2,1,0,737,137,6,119,1,825,28,5,29,107,12,0,0,138.4317713,221.1954465,228,2064,2144
달서구,용산1동,12419,30164,15073,15091,29988,15017,14971,176,56,120,2.41,3986,43.4,23383,1.29,1,0,4,2,0,913,180,23,112,2,970,26,1,19,96,16,0,0,244.4477198,91.74987975,228,2064,2144
달서구,용산2동,11332,27919,13987,13932,27702,13876,13826,217,111,106,2.44,3671,44,21151,1.32,1,0,3,6,0,503,154,21,65,2,480,16,1,4,50,15,0,0,226.2543393,93.88359788,228,2064,2144
달서구,이곡1동,9212,22806,11483,11323,22278,11146,11132,528,337,191,2.42,2927,43.5,12531,1.82,2,0,3,2,0,364,349,18,85,3,811,17,0,42,66,19,0,0,184.8188137,129.4455668,228,2064,2144
달서구,이곡2동,7076,16360,8341,8019,15872,8017,7855,488,324,164,2.24,2608,45.7,8020,2.04,0,53,1,2,0,550,407,5,47,7,832,32,50,2,31,16,0,0,132.5807153,145.0928331,228,2064,2144
달서구,신당동,17593,35497,18186,17311,30916,15700,15216,4581,2486,2095,1.76,4697,43.7,3796,9.35,1,65,4,2,2,1973,1244,37,178,10,2472,65,67,9,154,24,0,0,287.6661156,665.0088183,228,2064,2144
달서구,월성1동,13143,40350,19743,20607,40251,19691,20560,99,52,47,3.06,3258,37,18509,2.18,0,0,4,3,0,410,112,25,53,4,1376,17,2,131,47,6,0,0,326.9946126,155.0501844,228,2064,2144
달서구,월성2동,8306,16109,8014,8095,15221,7206,8015,888,808,80,1.83,4828,52.4,2557,6.3,2,0,3,5,0,1613,407,13,69,14,435,2,0,1,47,21,0,0,130.5466224,448.0808081,228,2064,2144
달서구,진천동,21355,51859,25308,26551,51567,25178,26389,292,130,162,2.41,8252,43.4,10149,5.11,1,14,5,3,0,865,263,46,186,4,2023,33,13,39,163,20,0,1,420.2630388,363.4433221,228,2064,2144
달서구,유천동,10917,33665,16563,17102,33605,16531,17074,60,32,28,3.08,1895,34.1,26932,1.25,0,0,4,0,0,468,256,18,38,5,706,4,0,89,24,14,0,0,272.8196687,88.90492224,228,2064,2144
달서구,상인1동,12948,34969,17068,17901,34889,17040,17849,80,28,52,2.69,5664,43.5,25158,1.39,1,3,3,6,0,417,136,18,49,8,1005,15,3,71,39,10,0,0,283.387227,98.86227353,228,2064,2144
달서구,상인2동,9220,19092,9435,9657,18970,9390,9580,122,45,77,2.06,3348,45.1,21213,0.9,1,0,1,0,0,214,108,16,105,1,1181,74,2,19,97,8,0,0,154.7207223,64.01154401,228,2064,2144
달서구,상인3동,6163,10847,5160,5687,10781,5135,5646,66,25,41,1.75,3638,54.2,2948,3.68,1,17,2,2,0,293,219,14,94,9,348,22,13,0,81,13,0,0,87.9036075,261.7360911,228,2064,2144
달서구,도원동,13808,34398,16567,17831,34323,16546,17777,75,21,54,2.49,6420,46,3230,10.65,2,9,4,4,0,496,360,20,84,4,615,15,10,15,61,23,0,0,278.7598682,757.4699375,228,2064,2144
달서구,송현1동,10122,19063,9490,9573,18645,9254,9391,418,236,182,1.84,4325,48.4,7749,2.46,0,6,1,0,0,217,92,26,156,1,818,14,6,7,146,10,0,0,154.4857076,174.964887,228,2064,2144
달서구,송현2동,9224,17996,8670,9326,17433,8369,9064,563,301,262,1.89,4655,50.1,18553,0.97,1,12,2,3,0,230,213,17,107,0,995,39,11,7,104,3,0,0,145.8387868,68.99021966,228,2064,2144
달서구,본동,6031,12242,6073,6169,11880,5859,6021,362,214,148,1.97,2760,48.7,11129,1.1,0,10,1,0,1,294,125,13,82,3,518,19,8,3,75,7,0,0,99.20862571,78.23633157,228,2064,2144
